b b b b b b b b b b b b b b b b b b b b b b b b 
b 0 0 0 0 0 0 0 0 0 0 0 0 0 0 0 0 0 0 0 0 0 0 b 
b 0 0 0 0 0 0 0 p 0 0 0 0 0 0 0 0 0 0 0 0 0 0 b 
b 0 0 b b b b b b 0 0 0 0 0 0 0 0 0 0 0 0 0 0 b 
b 0 0 0 0 0 0 0 0 0 0 0 0 0 0 0 0 0 0 0 0 0 0 b 
b 0 0 0 0 0 0 0 0 0 0 0 0 0 0 0 0 0 0 0 0 0 0 b 
b b b 0 0 s 0 0 0 0 0 0 0 0 0 0 0 0 0 0 0 0 0 b 
b 0 0 0 0 b 0 0 0 0 0 0 0 0 0 0 0 0 0 0 0 0 0 b 
b 0 0 0 0 0 0 0 b b 0 0 s 0 0 0 0 0 0 0 0 0 0 b 
b 0 0 0 0 0 0 0 0 0 0 0 b 0 0 0 0 0 0 0 0 0 0 b 
b 0 0 0 0 0 0 0 0 0 0 0 0 0 0 b b 0 0 s 0 0 0 b 
b 0 0 0 0 0 0 0 0 0 0 0 0 0 0 0 0 0 0 b 0 0 0 b 
b 0 0 0 0 0 0 0 0 0 0 0 0 0 0 0 0 0 0 0 0 0 0 b 
b 0 0 0 0 0 0 0 0 0 0 0 0 0 0 0 0 0 0 0 0 0 b b 
b 0 0 0 0 0 0 0 0 0 0 0 0 0 0 0 0 0 0 0 0 0 0 b 
b 0 0 0 0 0 0 0 0 0 0 0 0 0 s 0 0 b b 0 0 0 0 b 
b 0 0 0 0 0 0 0 0 0 0 0 0 0 b 0 0 0 0 0 0 0 0 b 
b 0 0 0 0 0 0 s 0 0 b b 0 0 0 0 0 0 0 0 0 0 0 b 
b 0 0 0 0 0 0 b 0 0 0 0 0 0 0 0 0 0 0 0 0 0 0 b 
b 0 0 b b 0 0 0 0 0 0 0 0 0 0 0 0 0 0 0 0 0 0 b 
b 0 0 b b 0 0 0 0 0 0 0 0 0 0 0 0 0 0 0 0 0 0 b 
b 0 0 b b l l l l l l l l l l l l l l l l l l b 
b b b b b b b b b b b b b b b b b b b b b b b b 
