b b b b b b b b b b b b b b b b b b b b b b b b 
b 0 0 0 0 0 0 0 0 0 0 0 0 0 0 0 0 0 0 0 0 0 0 b 
b 0 0 0 0 0 0 0 0 0 0 0 0 0 0 0 0 0 0 0 0 0 0 b 
b 0 0 0 0 0 0 0 0 0 0 0 0 0 0 0 0 0 0 0 0 0 0 b 
b 0 0 0 0 0 0 0 0 0 0 0 0 0 0 0 0 0 0 0 0 0 0 b 
b 0 0 0 0 0 0 0 0 0 0 0 0 0 0 0 0 0 0 0 0 0 0 b 
b 0 0 0 0 0 0 0 0 0 0 0 0 0 0 0 0 0 0 0 0 0 0 b 
b 0 0 0 0 0 0 0 0 0 0 0 0 0 0 0 0 0 0 0 0 0 0 b 
b 0 0 0 0 0 0 0 0 0 0 0 0 0 0 0 0 0 0 0 0 0 0 b 
b 0 0 0 0 0 0 0 0 0 0 0 0 0 0 0 0 0 0 0 0 0 0 b 
b 0 0 0 0 0 0 0 0 0 0 0 0 0 0 0 0 0 0 0 0 0 0 b 
b 0 0 0 0 0 0 b b b b b 0 0 0 0 0 0 0 0 0 0 0 b 
b 0 0 0 0 0 b l l l l l b 0 0 0 0 0 0 0 0 0 0 b 
b 0 0 0 0 b l 0 0 0 0 0 l b 0 0 0 0 0 0 0 0 0 b 
b 0 0 0 b l 0 0 0 0 0 0 0 l b 0 0 0 0 0 0 0 0 b 
b 0 0 0 l 0 0 0 0 0 0 0 0 0 l 0 0 0 0 0 0 0 0 b 
b s s s 0 0 0 0 0 0 0 0 0 0 0 0 0 0 0 0 0 0 0 b 
b b b b 0 0 0 0 0 0 0 0 0 0 0 0 0 0 0 0 0 0 0 b 
b 0 0 0 0 0 0 0 0 0 0 0 0 0 0 0 0 0 0 s s s 0 b 
b 0 0 0 b 0 0 0 0 0 0 0 0 0 0 s 0 0 0 b b b 0 b 
b 0 0 0 b 0 0 0 0 0 0 0 0 0 b b 0 0 0 b 0 0 0 b 
b 0 0 0 b 0 0 0 0 0 0 0 0 0 b b b s s b p 0 0 b 
b b b b b l l l l l l l l l b b b b b b b b b b 
